#################
#   #   #       #
### ### # ### ###
# #   # #   #   #
# ### # ### ### #
#   # #       # #
# ### # ####### #
# #   # # #     #
# # ### # # ### #
# #   #   # #   #
# ### ### # #####
#     #X  #     #
# ############# #
#   #     #   # #
### ### # # # # #
#       #   #   #
#################
