#########################
#   #X  #   #         # #
### # ### # # ##### # # #
#   # #   #   # #   #   #
# ### # ####### # ##### #
#   #           # #   # #
### ############# # ### #
# #   #         # #     #
# ### ### ##### # #######
#     #   #   # # #     #
# ##### ### # # # # ### #
# #     #   # # #     # #
# # # ### ##### ##### # #
# # #   #       #   # # #
# ##### # ####### # ### #
#     # #     #   #   # #
##### # ##### ### ### # #
#   # #   #   #   # #   #
# # # ### # ### ### ### #
# # #   # #   # #   # # #
# ##### # ### # ### # # #
#       #   # #   #   # #
# ######### # ### # ### #
#           #     #     #
#########################
