#####
#   #
### #
#X  #
### #
