#####
#   #
### #
#X X#
#####
