#####
#   #
### #
#   #
#####
