#####
#   #
### #
#X H#
#####
