######
#    #
###  #
#X   #
######
