#######
#     #
# ##  #
#X    #
#######
