#####################
#                   #
# ### ##### ### #####
#   # #   #   # #   #
### # # # ### # # # #
#X#   # # #   #   # #
# # ### # ######### #
# #   # #           #
# ### # ########### #
#   # #   # #     # #
# # # ### # # ### # #
# # #     # #   #   #
# # ####### ### #####
# #           # #   #
# ########### # ### #
# #   #     # #   # #
# # # ##### # ### # #
#   #     # #     # #
######### # ####### #
#                   #
#####################